Optimisation Pont-ve\'CS
Marie 	Saubusse 	Centrale Supélec
Romain 	Gérard 	Ponts ParisTech
Hector 	Martinet 	Ponts Paristech

ENITRO
Ahmed 	Belmabrouk 	ENSTA
Seta 	Rakotomandimby 	ENSTA
Sulian 	Le Bozec Chiffoleau 	Telecom sudparis

ENStre Libellules
Théophane 	Vallaeys 	ENS
Maena 	Quemener 	ENS Paris-Saclay
Victor 	Miquel 	ENS

Crustacés
Alexandre 	CHOTARD 	Ecole des Ponts ParisTech
Yann 	BOUCHEREAU 	Ecole des Ponts ParisTech
Simon 	MEUNIER 	Ecole des Ponts ParisTech

X
Maxime 	BARY 	Ecole Polytechnique
Mélisande 	DUHALDE 	ENPC
Antoine 	OLIVIER 	ENPC

ENSheep
Pacôme 	Luton 	ENS Mouflon
Elodie 	Bernard 	ENS Mouflon
Adrien 	Vannson 	ENS Mouflon

LaMiEquipe
Jim 	Vende 	ENPC
Eloi 	Trenquier 	ENPC
Jim 	Vende 	ENPC

OpTEAMisation
Gaëtan 	Patinier 	ENPC
Pierre 	Geraz 	ENPC
Michaël 	Laporte 	ENPC

Centrale Vacances
Valentin 	Billa 	Centrale Marseille
Adrien 	Zabban 	Centrale Marseille

TéléCommande
Hippolyte 	Verninas 	Télécom Paris
Inès 	Blanché 	Télécom Paris
Télo 	Philippe 	Télécom Paris

Ntarchakillers
Ezzehi 	Sofiane 	Ecole des Ponts
Majid 	Arthaud 	Ecole des Ponts
Paul 	Invernizzi 	Ecole des Ponts

Peli\'kRO
Benoit 	Duval 	ENPC
Manal 	Akhannouss 	ENPC
Bastien 	Le Chenadec 	ENPC

Neymar&amp;Mbappé
Adrien 	Sadé 	Ponts
Thibaud 	Cambronne 	Ponts
Bande 	DeGenies 	OnEstQue2

Kirocode8
Maximin 	Duvillard 	École nationale des ponts et chaussées

Made in Japan
Raffael 	Bolla Di Lorenzo 	Centralesupelec

Turbo Slaying
Timothé 	BOULET 	CentraleSupélec
Guillaume 	Levy 	CentraleSupélec
Void 	Void 	Void

catastrophologue
Héloïse 	Gachet 	ENPC
Elise 	Fressart 	ENPC
Héloïse 	Gachet 	ENPC

Bobinator
Dimitri 	Lanier 	Telecom Paris
Hugo 	Fontaine 	Telecom Paris
Phileas 	Thibault 	ENS Paris Saclay

Lékip
Lola 	Giordani 	École des Ponts
Christophe 	Hache 	CentraleSupélec
Louise 	Waquet 	École des Ponts

Les fruits de la pluie
Antoine 	Assier de Pompignan 	Télécom Paris
Hugo 	Crochet 	Télécom Paris
Antoine 	FAUVE 	Télécom Paris

ORgasm
Julien 	Cardinal 	CentraleSupélec
Samuel 	Sithakoul 	CentraleSupélec
Paul-Arno 	Lamarque 	CentraleSupélec

Optimierungsrechnung
Matthias 	Personnaz 	Centrale Lyon
Louis 	Personnaz 	Télécom Paris
Arnault 	Verret 	Télécom Paris

XOR
Mattia 	Mauro 	Ecole Polytechnique
Dan 	Timsit 	Ecole Polytechnique
Firas 	Ben Jedidia 	Ecole Polytechnique

Kiro Balboa
Antonin 	Joly 	Telecom Paris
Erwan 	Fagnou 	Telecom-Paris
Matteo 	Ratet 	Telecom Paris

Gasponts
Gaspard 	Lods 	ENPC
Lucas 	Langlade 	ENPC
Nicolas 	BUSCH 	ENPC

MPROdiges
Adrien 	Belfer 	ENPC
Hannes 	Van Overloop 	ENPC
Louise 	Eymery 	ENPC

Les simplexes
Tanguy 	Lourme 	Ecole des ponts
Mathis 	Wauquiez 	Ponts
Nicolas 	Bessin 	Ecole des ponts

La team
Lucas 	Sautier 	Ponts
Nicolas 	Corvol 	Ponts
Aurélia 	Attali 	Ponts

Team Tablier
Alexandre 	Ducorroy 	Ponts
Célestin 	Hans 	Ponts
Matthieu 	Carriere 	Ponts

Turinglearning
Nathan 	Aubert 	Ponts
Olivier 	Tournet 	Ponts
Charles 	Vielzeuf 	Ponts

Les indépontsdants
Lina 	Bekkali 	École des Ponts
Alexandre 	Chotard 	École des Ponts
Chloé 	Kemgne 	École des Ponts